111111111111111111111111111111111111111111111111111
111000000000CC001110000C000P00011111111111000000001
111000CC0C0C0000E1100000000001000000000000000000001
10000000000CC0000CCCCC00000011111111110000000000001
100011110000110000000000000000000000000CCC000000011
100000000000000000000000000011111111111111111111111
111111111111111111111111111111111111111111111111111