11111111
11110111
1C1001P1
10000001
10000001
100E0111
11111111