111111111111111111111111111111
111000000000CC001110000C001P11
111000CC0C0C0000E1100000001001
10000000000CC0000CCCCC00001011
100011110000110000\n0000001111
100000000000000000000000000011
1000CCC001111111000CCC1C000001
100000000000CC0000000000000001
1000000000000000000   00000001
1111100000      00000111111111
100000000000000000000000000CC1
111111000CC000C111111100000001
100000000000000000000000000001
111111111111111111000000000001
111111111111111111111111111111