111111
1E0C01
101001
101001
1P0001
111111
