111111111111111111111111111111
111000000000CC001110000C001P11
111000CC0C0C0000E1100000001001
10000000000CC0000CCCCC00001011
100011110000110000000000001111
100111110000000000000000000011
1001CCC111111111000CCC1C000001
100111110000CC0000000000000001
100000000000000000000000000001
111110000000000000000111111111
100000000000000000000000000CC1
111111000CC000C111111100000001
100000000000000000000000000001
111111111111111111000000000001
111111111111111111111111111111